*********6**********
5*******************
******@@@@@@***X****
@@@@@@@5432@@@@@@@@@
********************
***********@@@@@@@@*
*******@***@@@@@@@@*
*@@@@@4@***@@***6***
******@@***@@*******
*@*********@@*******
*3@@*******@@1******
@@@@@@@@@@@@@@@@@@@@
********************
***@@@@***@@@@@@@@@@
*****2@************1